# 28x16 grid. Vertical chase
============================
=..G..---..G..E....G..E....=
=.XXXXXX..XXXX..XXXXXX..X..=
=.X....L..L..X..L....X..X..=
=.X.G..L--L..X--L..G.X..X..=
=.X.XX.L..L..X..L.XX.X..X..=
=.X....L..L..X..L....X..X..=
=.XXXXXX..XXXX..XXXXXX..X..=
=..G..L--L....L--L..G...X..=
=.XXXXL..L.XXXL..L.XXXX.X..=
=.X..GL..L.X..XL..L.G..X...=
=.X..L..PL.X..XL.G.L..LX...=
=.X..L--LL.XXXXLL--L..LX...=
=.E...L..L......L..L..E.X...=
============================
