# 28x16 grid. Training grounds
============================
=....G....---....G....E....=
=.XXXXXX..X....X..XXXXXX..E=
=.X....X..X....X..X....X...=
=.X.P..L--X.LL.X--L..G.X...=
=.XXXX.X..X.LL.X..X.XXXX...=
=.....L..GX.LL.X..L....G...=
=.XXXXL.XXXX.LL.XXXX.XXXX..=
=.....L....L.LL.L....L..G..=
=.G..EL----L.LL.L----LE....=
=.XXXXL....L.XX.L....LXXXX.=
=.X..GL.E.L.X..L.E.LG..X...=
=.X..L....L.X..L...L...X...=
=.X..L----L.XXXX----L..X...=
=.E..L....L......O..L..E...=
============================
