# 28x16 grid. Gauntlet
============================
=..G..E..---..G..---..E..G.=
=.XXXXXX..XXXXXXX..XXXXXX..=
=.X....L..L....L..L....X...=
=.X.E..L--L..G.L--L..E.X...=
=.X.XX.L..L....L..L.XX.X...=
=.X....L..L.P..L..L....X...=
=.XXXXXX..LXXXXXL..XXXXXX..=
=.G....L--L....L--L....G...=
=.XXXX.L..L.XXXL..L.XXXX...=
=.X..GL..L.X..XL..L.G..X...=
=.X..L..EL.X..XL.E.L..LX...=
=.X..L--LL.XXXXLL--L..LX...=
=.E..L..L......L..L..E.X...=
=.G..L..L......O..L..L..G..=
============================
