# 28x16 grid. Shaft pursuit
============================
=E..G...L----L...G...E..G..=
=.XXXX..L....L..XXXX..XXXX.=
=.X..L..L.G..L..L..L..L..X.=
=.X..L--L.XXXL--L..L--L..X.=
=.X..L..L.X..XL.L..L..L..X.=
=.X..L--L.X..XL-L..L--L..X.=
=.X..L..L.X..XL.L..L..L..X.=
=.XXXX..L.XXXL..L.XXXX.XX.X=
=.G..L--L....L--L....L..G..=
=.XXXXL..XXXXXL..XXXXXL.XX.=
=.X..GL..X..P.X..L.G.L..X..=
=.X..L..EX..X.X..L..L..EX..=
=.X..L--LL..X.L--L..L--LX..=
=.E..L....G....O....G..L...=
============================
