# 28x16
============================
=..G.....................=
=..XXXXXXX....XXXXXXX....=
=..X.....L....L.....X....=
=..X..G..L----L..G..X....=
=..X.....L....L.....X....=
=..XXXXXXX....XXXXXXX....=
=........L....L........G=
=..XXXX..L----L..XXXX....=
=..X..X..L....L..X..X....=
=..X..X..L....L..X..X....=
=..X..XXXX....XXXX..X....=
=..X................X....=
=..P........E.......X....=
=.................G.X....=
============================
