export const LEVEL_04 = {
  tileSize: 16,
  width: 20,
  height: 16,
  playerSpawn: { x: 4, y: 3 },
  enemySpawns: [  { tx: 10, ty: 9, dir: -1 }, { tx: 14, ty: 9, dir: 1 }, { tx: 6, ty: 7, dir: 1 }  ],
  // 0 empty, 1 solid, 2 semi-solid (one-way from above)
  tiles: [
    // 0
    0,0,0,0,0,0,0,0,0,0,0,0,0,0,0,0,0,0,0,0,
    // 1
    0,0,0,0,0,0,0,0,0,0,0,0,0,0,0,0,0,0,0,0,
    // 2
    0,0,0,0,0,0,0,0,0,0,0,0,0,0,0,0,0,0,0,0,
    // 3
    0,0,0,0,0,0,0,0,0,0,0,0,0,0,0,0,0,0,0,0,
    // 4
    0,0,0,0,0,0,0,0,0,0,0,0,0,0,0,0,0,0,0,0,
    // 5
    0,0,0,0,0,0,2,2,0,0,0,2,2,0,0,0,0,0,0,0,
    // 6
    0,0,0,0,0,0,0,0,0,0,0,0,0,0,0,0,0,0,0,0,
    // 7
    0,0,0,0,0,0,0,0,2,2,2,0,0,0,0,0,0,0,0,0,
    // 8
    0,0,0,0,0,0,0,0,0,0,0,0,0,0,0,0,0,0,0,0,
    // 9
    0,0,0,2,2,2,0,0,0,0,0,0,2,2,2,0,0,0,0,0,
    // 10
    0,0,0,0,0,0,0,0,0,0,0,0,0,0,0,0,0,0,0,0,
    // 11
    0,0,0,0,0,0,0,0,0,0,0,0,0,0,0,0,0,0,0,0,
    // 12
    0,0,0,0,0,0,0,0,0,0,0,0,0,0,0,0,0,0,0,0,
    // 13
    0,0,0,0,0,0,0,0,0,0,0,0,0,0,0,0,0,0,0,0,
    // 14
    0,0,0,0,0,0,0,0,0,0,0,0,0,0,0,0,0,0,0,0,
    // 15
    1,1,1,1,1,1,1,1,1,1,1,1,1,1,1,1,1,1,1,1
  ],
};
