export const LEVEL_01 = {
  width: 16,
  height: 14,
  tileSize: 16,
  // 0 empty, 1 solid platform. 14 rows x 16 cols (top→bottom)
  tiles: [
    // 0
    0,0,0,0,0,0,0,0,0,0,0,0,0,0,0,0,
    // 1
    0,0,0,0,0,0,0,0,0,0,0,0,0,0,0,0,
    // 2
    0,0,0,0,0,0,0,0,0,0,0,0,0,0,0,0,
    // 3
    0,0,0,0,0,0,1,1,0,0,0,0,0,0,0,0,
    // 4
    0,0,0,0,0,0,0,0,0,0,0,0,0,0,0,0,
    // 5
    0,0,0,0,0,0,0,0,1,1,1,0,0,0,0,0,
    // 6
    0,0,0,0,0,0,0,0,0,0,0,0,0,0,0,0,
    // 7
    0,0,0,0,0,1,1,0,0,0,0,0,0,0,0,0,
    // 8
    0,0,0,0,0,0,0,0,0,0,0,0,0,0,0,0,
    // 9
    0,0,0,1,1,0,0,0,0,0,1,1,0,0,0,0,
    // 10
    0,0,0,0,0,0,0,0,0,0,0,0,0,0,0,0,
    // 11
    0,0,0,0,0,0,0,0,0,0,0,0,0,0,0,0,
    // 12
    0,0,0,0,0,0,0,0,0,0,0,0,0,0,0,0,
    // 13
    1,1,1,1,1,1,1,1,1,1,1,1,1,1,1,1
  ],
  playerSpawn: { x: 2, y: 12 }
};
