export const LEVEL_02 = {
  tileSize: 16,
  width: 16,
  height: 14,
  playerSpawn: { x: 1, y: 1 },
  enemySpawns: [ { tx: 12, ty: 13, dir: -1 }, { tx: 9, ty: 7, dir: -1 }, { tx: 2, ty: 5, dir: 1 } ],
  tiles: [
    // 0
    0,0,0,0,0,0,0,0,0,0,0,0,0,0,0,0,
    // 1
    0,0,0,0,0,0,0,0,0,0,0,0,0,0,0,0,
    // 2
    0,0,0,1,1,1,0,0,0,1,1,0,0,0,0,0,
    // 3
    0,0,0,0,0,0,0,0,0,0,0,0,0,0,0,0,
    // 4
    0,1,1,0,0,0,0,0,0,0,0,0,1,0,0,0,
    // 5
    0,0,0,0,0,0,0,0,0,0,0,0,0,0,0,0,
    // 6
    0,0,0,0,1,1,1,0,0,1,1,1,0,0,0,0,
    // 7
    0,0,0,0,0,0,0,0,0,0,0,0,0,0,0,0,
    // 8
    0,0,1,1,0,0,0,0,0,0,0,0,1,1,0,0,
    // 9
    0,0,0,0,0,0,0,0,0,0,0,0,0,0,0,0,
    // 10
    0,0,0,0,0,0,0,0,0,0,0,0,0,0,0,0,
    // 11
    0,0,0,0,0,0,0,0,0,0,0,0,0,0,0,0,
    // 12
    0,0,0,0,0,0,0,0,0,0,0,0,0,0,0,0,
    // 13
    1,1,1,1,1,1,1,1,1,1,1,1,1,1,1,1
  ],
};
