export const LEVEL_03 = {
  tileSize: 16,
  width: 20,
  height: 16,
  playerSpawn: { x: 10, y: 3 },
  enemySpawns: [  { tx: 5, ty: 9, dir: 1 }, { tx: 15, ty: 9, dir: -1 }, { tx: 10, ty: 15, dir: 1 }  ],
  tiles: [
    // 0
    0,0,0,0,0,0,0,0,0,0,0,0,0,0,0,0,0,0,0,0,
    // 1
    0,0,0,0,0,0,0,0,0,0,0,0,0,0,0,0,0,0,0,0,
    // 2
    0,0,0,0,0,0,0,0,0,0,0,0,0,0,0,0,0,0,0,0,
    // 3
    0,0,0,0,0,0,0,0,0,0,0,0,0,0,0,0,0,0,0,0,
    // 4
    0,0,0,0,0,0,0,0,1,1,1,1,0,0,0,0,0,0,0,0,
    // 5
    0,0,0,0,0,0,0,0,0,0,0,0,0,0,0,0,0,0,0,0,
    // 6
    0,0,0,0,0,0,0,0,0,0,0,0,0,0,0,0,0,0,0,0,
    // 7
    0,0,0,0,0,0,0,0,0,0,0,0,0,0,0,0,0,0,0,0,
    // 8
    0,0,0,1,1,1,1,1,0,0,0,0,0,0,1,1,1,0,0,0,
    // 9
    0,0,0,0,0,0,0,0,0,0,0,0,0,0,0,0,0,0,0,0,
    // 10
    0,0,0,0,0,0,0,0,1,1,0,0,1,1,0,0,0,0,0,0,
    // 11
    0,0,0,0,0,0,0,0,0,0,0,0,0,0,0,0,0,0,0,0,
    // 12
    0,0,0,0,0,0,0,0,0,0,0,0,0,0,0,0,0,0,0,0,
    // 13
    0,0,0,0,0,0,0,0,0,0,0,0,0,0,0,0,0,0,0,0,
    // 14
    0,0,0,0,0,0,0,0,0,0,0,0,0,0,0,0,0,0,0,0,
    // 15
    1,1,1,1,1,1,1,1,1,1,1,1,1,1,1,1,1,1,1,1
  ],
};
